ASSIGNMENT 1 : RLI_17_00 

GROUP 0 : GLORIA PARASCHIVOIU, ANDREI BARAITARU, RODRIGO JESÚS SAGASTEGUI MARTÍNEZ
GROUP 1 : ANNA SHATS, ZAID SAAD NADEEM AL TAYAN, ANGEL LOPEZ TORRALBA
GROUP 2 : JORGE VARGAS TIMÓN, FARAH ORFALY, EDOUARD PIERRE WIDMAIER-RUIZ-PICASSO
GROUP 3 : LEONARDO CAMILLERI, DAVID OREOLUWA AYOMIDE ADEAKIN, ZAID KHALED (AHMAD FAWZI) ALSAHEB
GROUP 4 : SEBASTIAN PERILLA ESPINOSA, <NOBODY>, GUY MAZAR
GROUP 5 : ALEXANDRA KHREICHE, JA´FAR MOHAMMED AHMAD OBEIDAT, ILARIA PAPILLO
GROUP 6 : PÉTER NORBERT KARACS, CLARA MOUZANNAR, ANDRÉS JOSÉ TABOADA SANTAMARÍA
GROUP 7 : ELS ALEKSANDRA VAKS, SALEH HASSAN IBRAHIM HASSAN ABD ELRAHMAN, RICARDO ANDRÉS MENDEZ CAVALIERI
GROUP 8 : DANIEL ARTURO MORA SOLER, JOSE ANTONIO IZARRA MILLAN, SOFÍA VITORICA NOGUES
GROUP 9 : KARL MOUCHANTAF, ISMAEL PICAZO FLORES, MASSIMO GIUSEPPE RIDELLA
GROUP 10 : DANIEL MARCOS SÁNCHEZ VELILLA, LAURA PATRICIA CUELLAR CAMACHO, LUIS GÓMEZ-ACEBO MARTÍN-RETORTILLO

SALEH HASSAN IBRAHIM HASSAN ABD ELRAHMAN : GROUP 7 WITH ELS ALEKSANDRA VAKS, RICARDO ANDRÉS MENDEZ CAVALIERI
DAVID OREOLUWA AYOMIDE ADEAKIN : GROUP 3 WITH LEONARDO CAMILLERI, ZAID KHALED (AHMAD FAWZI) ALSAHEB
ZAID KHALED (AHMAD FAWZI) ALSAHEB : GROUP 3 WITH LEONARDO CAMILLERI, DAVID OREOLUWA AYOMIDE ADEAKIN
ZAID SAAD NADEEM AL TAYAN : GROUP 1 WITH ANNA SHATS, ANGEL LOPEZ TORRALBA
ANDREI BARAITARU : GROUP 0 WITH GLORIA PARASCHIVOIU, RODRIGO JESÚS SAGASTEGUI MARTÍNEZ
LEONARDO CAMILLERI : GROUP 3 WITH DAVID OREOLUWA AYOMIDE ADEAKIN, ZAID KHALED (AHMAD FAWZI) ALSAHEB
LAURA PATRICIA CUELLAR CAMACHO : GROUP 10 WITH DANIEL MARCOS SÁNCHEZ VELILLA, LUIS GÓMEZ-ACEBO MARTÍN-RETORTILLO
LUIS GÓMEZ-ACEBO MARTÍN-RETORTILLO : GROUP 10 WITH DANIEL MARCOS SÁNCHEZ VELILLA, LAURA PATRICIA CUELLAR CAMACHO
JOSE ANTONIO IZARRA MILLAN : GROUP 8 WITH DANIEL ARTURO MORA SOLER, SOFÍA VITORICA NOGUES
PÉTER NORBERT KARACS : GROUP 6 WITH CLARA MOUZANNAR, ANDRÉS JOSÉ TABOADA SANTAMARÍA
ALEXANDRA KHREICHE : GROUP 5 WITH JA´FAR MOHAMMED AHMAD OBEIDAT, ILARIA PAPILLO
ANGEL LOPEZ TORRALBA : GROUP 1 WITH ANNA SHATS, ZAID SAAD NADEEM AL TAYAN
GUY MAZAR : GROUP 4 WITH SEBASTIAN PERILLA ESPINOSA, <NOBODY>
RICARDO ANDRÉS MENDEZ CAVALIERI : GROUP 7 WITH ELS ALEKSANDRA VAKS, SALEH HASSAN IBRAHIM HASSAN ABD ELRAHMAN
DANIEL ARTURO MORA SOLER : GROUP 8 WITH JOSE ANTONIO IZARRA MILLAN, SOFÍA VITORICA NOGUES
KARL MOUCHANTAF : GROUP 9 WITH ISMAEL PICAZO FLORES, MASSIMO GIUSEPPE RIDELLA
CLARA MOUZANNAR : GROUP 6 WITH PÉTER NORBERT KARACS, ANDRÉS JOSÉ TABOADA SANTAMARÍA
JA´FAR MOHAMMED AHMAD OBEIDAT : GROUP 5 WITH ALEXANDRA KHREICHE, ILARIA PAPILLO
FARAH ORFALY : GROUP 2 WITH JORGE VARGAS TIMÓN, EDOUARD PIERRE WIDMAIER-RUIZ-PICASSO
ILARIA PAPILLO : GROUP 5 WITH ALEXANDRA KHREICHE, JA´FAR MOHAMMED AHMAD OBEIDAT
GLORIA PARASCHIVOIU : GROUP 0 WITH ANDREI BARAITARU, RODRIGO JESÚS SAGASTEGUI MARTÍNEZ
SEBASTIAN PERILLA ESPINOSA : GROUP 4 WITH <NOBODY>, GUY MAZAR
ISMAEL PICAZO FLORES : GROUP 9 WITH KARL MOUCHANTAF, MASSIMO GIUSEPPE RIDELLA
MASSIMO GIUSEPPE RIDELLA : GROUP 9 WITH KARL MOUCHANTAF, ISMAEL PICAZO FLORES
RODRIGO JESÚS SAGASTEGUI MARTÍNEZ : GROUP 0 WITH GLORIA PARASCHIVOIU, ANDREI BARAITARU
DANIEL MARCOS SÁNCHEZ VELILLA : GROUP 10 WITH LAURA PATRICIA CUELLAR CAMACHO, LUIS GÓMEZ-ACEBO MARTÍN-RETORTILLO
ANNA SHATS : GROUP 1 WITH ZAID SAAD NADEEM AL TAYAN, ANGEL LOPEZ TORRALBA
ANDRÉS JOSÉ TABOADA SANTAMARÍA : GROUP 6 WITH PÉTER NORBERT KARACS, CLARA MOUZANNAR
ELS ALEKSANDRA VAKS : GROUP 7 WITH SALEH HASSAN IBRAHIM HASSAN ABD ELRAHMAN, RICARDO ANDRÉS MENDEZ CAVALIERI
JORGE VARGAS TIMÓN : GROUP 2 WITH FARAH ORFALY, EDOUARD PIERRE WIDMAIER-RUIZ-PICASSO
SOFÍA VITORICA NOGUES : GROUP 8 WITH DANIEL ARTURO MORA SOLER, JOSE ANTONIO IZARRA MILLAN
EDOUARD PIERRE WIDMAIER-RUIZ-PICASSO : GROUP 2 WITH JORGE VARGAS TIMÓN, FARAH ORFALY
<NOBODY> : GROUP 4 WITH SEBASTIAN PERILLA ESPINOSA, GUY MAZAR
