ASSIGNMENT 1 : RLI_17_00 

GROUP 0 : ASWIN SUBRAMANIAN MAHESWARAN, ALBERTO PULIGA, EVAN COLE WELSH
GROUP 1 : AYA-YASMINE BELLOUM, MAKENNA MARIE WARNER, THULFIQAR KHALEEL ABED AL-SHAHEEB
GROUP 2 : DANIEL RÖSEL, JASKARAN SINGH GHAI, SHAHAF BRENNER
GROUP 3 : WESSAM MADKHANA, INDIA LUCÍA ANTÚNEZ SÁNCHEZ, PAUL, LOUIS, VINCENT, JUAN DE RUIZ--ALLIATA
GROUP 4 : MATHIAS ALEXANDER ZMUDA, TALINE FAHED H. SHAWWA, VICTOR BELLENS
GROUP 5 : TRINIDAD ROCA, KYE ELECTRICITEH, SERGIO VERDUGO RUBIO
GROUP 6 : JUAN DIEGO FERNÁNDEZ ARAUJO, ADRIÁN DE LA TORRE BLÁZQUEZ, PIETRO RODRIGANO ABRIL
GROUP 7 : GREGORIO GIUSEPPE ORLANDO, TOMÁS MESALLES MEJÍA, DIANA RUBAGA
GROUP 8 : LARBI BENAMOUR, NOAH VALDERRAMA HERNANDO, JOSÉ MIGUEL SERRANO FLORES
GROUP 9 : ANTHONY-LEE SANCHEZ, DANIEL KEN KUMLIN, RONALD SEBASTIÁN BELTRÁN NÚÑEZ
GROUP 10 : BAPTISTE ETROY, FYNN LUKAS FRÜHLING, CELINE KHALED FAWWAZ ALZOU´BI
GROUP 11 : HUSEYIN EMIR BAYRAK, PEDRO TORRADO AGUILAR CAUZ, ANNA KATHLEEN PAYNE

THULFIQAR KHALEEL ABED AL-SHAHEEB : GROUP 1 WITH AYA-YASMINE BELLOUM, MAKENNA MARIE WARNER
CELINE KHALED FAWWAZ ALZOU´BI : GROUP 10 WITH BAPTISTE ETROY, FYNN LUKAS FRÜHLING
INDIA LUCÍA ANTÚNEZ SÁNCHEZ : GROUP 3 WITH WESSAM MADKHANA, PAUL, LOUIS, VINCENT, JUAN DE RUIZ--ALLIATA
HUSEYIN EMIR BAYRAK : GROUP 11 WITH PEDRO TORRADO AGUILAR CAUZ, ANNA KATHLEEN PAYNE
VICTOR BELLENS : GROUP 4 WITH MATHIAS ALEXANDER ZMUDA, TALINE FAHED H. SHAWWA
AYA-YASMINE BELLOUM : GROUP 1 WITH MAKENNA MARIE WARNER, THULFIQAR KHALEEL ABED AL-SHAHEEB
RONALD SEBASTIÁN BELTRÁN NÚÑEZ : GROUP 9 WITH ANTHONY-LEE SANCHEZ, DANIEL KEN KUMLIN
LARBI BENAMOUR : GROUP 8 WITH NOAH VALDERRAMA HERNANDO, JOSÉ MIGUEL SERRANO FLORES
SHAHAF BRENNER : GROUP 2 WITH DANIEL RÖSEL, JASKARAN SINGH GHAI
ADRIÁN DE LA TORRE BLÁZQUEZ : GROUP 6 WITH JUAN DIEGO FERNÁNDEZ ARAUJO, PIETRO RODRIGANO ABRIL
KYE ELECTRICITEH : GROUP 5 WITH TRINIDAD ROCA, SERGIO VERDUGO RUBIO
BAPTISTE ETROY : GROUP 10 WITH FYNN LUKAS FRÜHLING, CELINE KHALED FAWWAZ ALZOU´BI
JUAN DIEGO FERNÁNDEZ ARAUJO : GROUP 6 WITH ADRIÁN DE LA TORRE BLÁZQUEZ, PIETRO RODRIGANO ABRIL
FYNN LUKAS FRÜHLING : GROUP 10 WITH BAPTISTE ETROY, CELINE KHALED FAWWAZ ALZOU´BI
JASKARAN SINGH GHAI : GROUP 2 WITH DANIEL RÖSEL, SHAHAF BRENNER
DANIEL KEN KUMLIN : GROUP 9 WITH ANTHONY-LEE SANCHEZ, RONALD SEBASTIÁN BELTRÁN NÚÑEZ
WESSAM MADKHANA : GROUP 3 WITH INDIA LUCÍA ANTÚNEZ SÁNCHEZ, PAUL, LOUIS, VINCENT, JUAN DE RUIZ--ALLIATA
TOMÁS MESALLES MEJÍA : GROUP 7 WITH GREGORIO GIUSEPPE ORLANDO, DIANA RUBAGA
GREGORIO GIUSEPPE ORLANDO : GROUP 7 WITH TOMÁS MESALLES MEJÍA, DIANA RUBAGA
ANNA KATHLEEN PAYNE : GROUP 11 WITH HUSEYIN EMIR BAYRAK, PEDRO TORRADO AGUILAR CAUZ
ALBERTO PULIGA : GROUP 0 WITH ASWIN SUBRAMANIAN MAHESWARAN, EVAN COLE WELSH
TRINIDAD ROCA : GROUP 5 WITH KYE ELECTRICITEH, SERGIO VERDUGO RUBIO
PIETRO RODRIGANO ABRIL : GROUP 6 WITH JUAN DIEGO FERNÁNDEZ ARAUJO, ADRIÁN DE LA TORRE BLÁZQUEZ
DANIEL RÖSEL : GROUP 2 WITH JASKARAN SINGH GHAI, SHAHAF BRENNER
DIANA RUBAGA : GROUP 7 WITH GREGORIO GIUSEPPE ORLANDO, TOMÁS MESALLES MEJÍA
PAUL, LOUIS, VINCENT, JUAN DE RUIZ--ALLIATA : GROUP 3 WITH WESSAM MADKHANA, INDIA LUCÍA ANTÚNEZ SÁNCHEZ
ANTHONY-LEE SANCHEZ : GROUP 9 WITH DANIEL KEN KUMLIN, RONALD SEBASTIÁN BELTRÁN NÚÑEZ
JOSÉ MIGUEL SERRANO FLORES : GROUP 8 WITH LARBI BENAMOUR, NOAH VALDERRAMA HERNANDO
TALINE FAHED H. SHAWWA : GROUP 4 WITH MATHIAS ALEXANDER ZMUDA, VICTOR BELLENS
ASWIN SUBRAMANIAN MAHESWARAN : GROUP 0 WITH ALBERTO PULIGA, EVAN COLE WELSH
PEDRO TORRADO AGUILAR CAUZ : GROUP 11 WITH HUSEYIN EMIR BAYRAK, ANNA KATHLEEN PAYNE
NOAH VALDERRAMA HERNANDO : GROUP 8 WITH LARBI BENAMOUR, JOSÉ MIGUEL SERRANO FLORES
SERGIO VERDUGO RUBIO : GROUP 5 WITH TRINIDAD ROCA, KYE ELECTRICITEH
MAKENNA MARIE WARNER : GROUP 1 WITH AYA-YASMINE BELLOUM, THULFIQAR KHALEEL ABED AL-SHAHEEB
EVAN COLE WELSH : GROUP 0 WITH ASWIN SUBRAMANIAN MAHESWARAN, ALBERTO PULIGA
MATHIAS ALEXANDER ZMUDA : GROUP 4 WITH TALINE FAHED H. SHAWWA, VICTOR BELLENS
